..........
.###......
..........
..........
..........
..........
..........
..##......
..........
..#.......